12 12
111111111111
111111111111
110000000011
110220000011
110000010011
111111110011
110000010011
110300000011
110304010011
110000010011
111111111111
111111111111