12 12
111111111111
111111111111
110000000011
110300000011
110000010011
111111110011
110000010011
110020000011
110040010011
110000010011
111111111111
111111111111