12 12
111111111111
111111111111
110001111111
110100020111
110001110111
110002000111
111110110111
111110110111
110300000011
110304000011
111111111111
111111111111