12 12
111111111111
111111111111
111111111011
111111110011
110002220011
110301110011
110001112111
110400000011
110000000011
111111111111
111111111111
111111111111