11 12
11111111111
11111111111
11111311111
11111311111
11100301111
11100201111
11112121111
11110000111
11114000111
11111111111
11111111111
11111111111